ADD	AE D
BOTTOM	B AA T AH M
CUBE	K Y UW B
CYLINDER	S IH L AH N D ER
CYLINDER(2)	S IH L IH N D ER
DOWN	D AW N
EIGHT	EY T
FIVE	F AY V
FOUR	F AO R
FRONT	F R AH N T
HERE	HH IY R
LEFT	L EH F T
MONKEY	M AH NG K IY
MOVE	M UW V
NINE	N AY N
ONE	W AH N
ONE(2)	HH W AH N
PIXEL	P IH K S AH L
PIXELS	P IH K S AH L Z
RENAME	R IY N EY M
RIGHT	R AY T
SELECT	S AH L EH K T
SEVEN	S EH V AH N
SIX	S IH K S
TEN	T EH N
THREE	TH R IY
TOP	T AA P
TOP(2)	T AO P
TWO	T UW
UP	AH P